-1
########    ############
#.....@#    #.D........#
#......#    #.d..###...#    ######
#......######....# #...#    #....#
#................# #...#    #....#
#..@....Aa.......###...######....#
#............@.....Bb............#
#.....######.............@.......#
#.....#    #.Cc......#############
#######    #.........#
           ######....#
                ######