-1
######
#Aa.@#
#Bb.@#
#Cc.@#
#Dd.@#
######
